13
13
0.5
5.2
5.5
52
6
6
6
4
2
1
2222222000000
2111134200000
2121212320000
2111111112000
2121212121200
2111133111120
2121233321212
0211113311112
0021212121212
0002111111112
0000232121212
0000026311112
0000002222222
