17
17
0.8
6.95
6.9
100
9
9
9
6
6
3
22222222200000000
21111113420000000
21212121232000000
21111111111200000
21212121212120000
21111111111112000
21212121212121200
23111111331111120
28212121333121212
02311111133111112
00212121212121212
00021111111111112
00002121212121212
00000211111111112
00000023212121232
00000002631111372
00000000222222222
