21
21
1.0
8.5
8.5
180
12
12
12
9
3
3
222222222220000000000
211113431112000000000
212121212121200000000
211111111111120000000
212121212121232000000
211111111111115200000
212121212121212320000
211111111111111112000
212121212121212121200
231111113311111111120
282121213331212121212
023111111331111111112
002121212121212121212
000211111111111111112
000021212121212121212
000002111111111111112
000000212121212121212
000000021111111111112
000000002321212121232
000000000263111111372
000000000022222222222
