2222222000000
2111133200000
2121212320000
2111111112000
2121212121200
2111133111120
2121233321212
0211113311112
0021212121212
0002111111112
0000232121212
0000023311112
0000002222222
